NO ./textures.help/north.xpm
SO ./textures.help/south.xpm
WE ./textures.help/west.xpm
EA ./textures.help/east.xpm

F 164,169,20
C 153,204,255

 11111111111111111111
100000000000000000001
111111111011111110001
100000000010010000001
110000000010010000001
100000101011111000001
1N1000001000000000001
111111111111111111111
