NO ./textures.help/north.xpm
SO ./textures.help/south.xpm
WE ./textures.help/west.xpm
EA ./textures.help/east.xpm

C 53,41,34
F 45,33,27

111111111111111
111111000111111
111110000011111
1111000S0001111
111000000000111
110000001000011
100001101100001
110000101000011
111000010000111
111100000001111
111110000011111
111111000111111
111111111111111
