NO ./textures.help/north.xpm
SO ./textures.help/south.xpm
WE ./textures.help/west.xpm
EA ./textures.help/east.xpm
F 150,75,0
C 0,0,0

111111111111111
100000000000001
100000000000001
100000000000001
100000000000001
100000000000001
100000100000001
100000000000011
100000010000001
100001000000001
1111111100N0011
111111100000111
111111111101001
111111111111111
