NO ./textures.help/north.xpm
SO ./textures.help/south.xpm
WE ./textures.help/west.xpm
EA ./textures.help/east.xpm
F 150,75,0
C 0,0,0
                      11111111111
        1111111111111110000000001
        1111111111000000000000001
        1001000000000000000000001
111111111011000000000000000000001
100000000011000000000111111111111
11110111111111011100000010001
11110111111111011101010010001
11000000110101011100000010101
10000E00000000001100000010101
10000000000000001101010010101
11111111111111111111111111111
