NO ./textures.help/north.xpm
SO ./textures.help/south.xpm
WE ./textures.help/west.xpm
EA ./textures.help/east.xpm
F 150,75,0
C 0,0,0
        1111111111111111111111111
        1000000000110000000000001
        1011000001110000000000001
        1001000000000000000E00001
111111111011000001110000000000001
100000000011000001110111111111111
11110111111111011100000010001
1111011111111101110101001001
11000000110101011100000010101
10000000000000001100000010101
10000000000000001101010010101
11000001110101011111011110001
11110111 1110101 101111010001
11111111 1111111 111111111111
