SO ./textures/south.xpm
WE ./textures/west.xpm
EA ./textures/east.xpm

111111111111111
1000000000000W1
111111111111111